ALL	AO L
CHARLIE	CH AA R L IY
DO	D UW
FIDGET	F IH JH IH T
IS	IH Z
KNOW	N OW
MUSIC	M Y UW Z IH K
PLAY	P L EY
SOYLENT	S OY L EH N T
SPINNER	S P IH N ER
STAR	S T AA R
TEMPERATURE	T EH M P R AH CH ER
TEMPERATURE(2)	T EH M P ER AH CH ER
THE	DH AH
THE(2)	DH IY
TOTO	T OW T OW
WAY	W EY
WEATHER	W EH DH ER
WHAT	W AH T
WHAT(2)	HH W AH T
YOU	Y UW
